ステージ,生成,ステージのサイズは,,最高縦横50,,,,,,
5,3,3,4,3,3,3,3,3,5,
5,3,3,3,3,5,3,3,3,3,
6,5,3,3,3,3,3,3,3,3,
3,5,3,3,3,5,3,5,3,3,
3,3,3,3,4,3,3,3,3,4,
5,3,3,4,3,7,5,3,3,3,
3,5,4,3,3,3,3,5,3,3,
3,3,3,3,3,4,3,3,5,4,
4,3,3,3,3,3,3,4,3,3,
3,3,3,3,3,3,3,3,3,3,2
5,3,4,3,3,4,3,3,3,1,2
